11111111111111111111
1N0C00010000000000E1
10000001100111011001
1110000C000001011001
100010101110000N0001
1000101000100C000001
10001110111000110001
1010001010N0C0010001
1P100010111000010001
11111111111111111111