11111111111111111111
100C00010000000000E1
10000001100111011001
1110000C000001011001
10001010111000000001
1000101000100C000001
10001110111000110001
101000101000C0010001
1P100010111000010001
11111111111111111111