11111111111111111111
10000001000000000001
10000001100111011001
11100000000001011001
10001010111000000001
10001010001000000001
10001110111000110001
10100010100000010001
10100010111000010001
11111111111111111111