11111111111
11110C01111
11111101111
11110C01111
11110001111
1000000N001
1C000P000E1
10N00000001
11110C01111
11110001111
11110001111
11111111111